00010000
0000#020
0#0000+0
00+00200
000100+0
00#000#0