00000000
0000+0#0
0#002000
+0000001
00200+00
0#+00001