00000000
0000+##0
0#0000+0
02000200
01+00#00
00000010