00000000
0000#0+0
0+002000
010000#0
00#+0001
0#000+00