00000000
0000+00#
002000+0
0#00#001
010+0002
0#000000