00000000
0000+002
00#000+0
0#001000
+000002#
0#00+000