00000000
0000+0#0
0+00200#
02#00+00
01+00001
00000000