00000000
0000#0+0
0+00000#
01#00000
002+0020
00000+01