00000000
0000+00#
0#002000
+010+000
002#0001
00+00#00