00000000
0000+0#0
00000200
01+00+00
00200001
0#0000#0